XXXXXXXXXXXXXXXXXXXX
X                  X
X          XXXX    X
X    P             X
X         XXXX     X
X                  X
XXXXXXXXXXXXXXXXXXXX